1111111111111111111111111111111111111111111111111111111111111
1000000000000000000000000000000000000000000000000000000000001
1001111100000111110000000111110000000100000111110000111111101
1010000000001000001000001000000000001100001000001000100000001
1010000000001000000000001000000000000100001000000000100000001
1010000000001000000000001000000000000100001000000000100000001
1010000000001000000000001000000000000100001000000000100000001
1010000000001000000000001000000000000100001000000000100000001
1010000000001111110000001111110000000100001111110000111111101
1010000000000000001000001000000000000100001000001000000000101
1010000000000000001000001000000000000100001000001000000000101
1010000000000000001000001000000000000100001000001000000000101
1010000000000000001000001000000000000100001000001000000000101
1010000000001000001000001000000000000100001000001000000000101
1001111100000111111000000111110000011111000111111000111111101
100000000000000000000000000p000000000000000000000000000000001
1111111111111111111111111111111111111111111111111111111111111

0 ball
1 wall
2 gate          (only one)
p pacman        (only one)
g ghost         (only four)
3 blank
4 power ball
x pacmanTwo

1
1
1
1
1
1
1
1
1
1
1
1
1
1
1
1
1
