111111111111111111111111111111111111111111111111111111
140000000000004000000000000000000000004000000000000041
100111111000111111001111110001110100111111000111111101
101111111001111111101111110011110101111111100111111101
101100000001100000001100000111110101100000000110000001
101101111101101111101101110001110101101111010110111101
101100000001101111101100000101110101101111010110000001
101101111101100000001111110101110101100000000111111101
101100000001111111001111110101110001112211000111111101
101101111100111111101111110101110101113311100000001101
101100000000000001101100000101110101133331101111101101
101101111101111101101101110101110101133331101111101101
101100000000000001101100000001110001133331100000001101
101111111001111111101111110011111001111111100111111101
100111111000111111001111110111111100111111000111111001
140000000000004000000000000p00000000004000000000000041
111111111111111111111111111111111111111111111111111111
1111111111111111111111111111111111111111
0 ball
1 wall
2 gate          (only one)
p pacman        (only one)
g ghost         (only four)
3 blank
4 power ball
x pacmanTwo

1
1
1
1
1
1
1
1
1
1
1
1
1
1
1
1
1
