111111111111111111111111111111111
1g0040000000000010000000000040001
101111110111111010111111011111101
100000004000000000000000400000001
101111110101111111111101011111101
100040000100000010000001000040001
111111110111111010111111011111111
333333310100400000004001013333333
333333310101111222111101013333333
33333331000133333333g100013333333
333333310101333333333101013333333
33333331000133333333g100013333333
333333310101111111111101013333333
333333310100400000004001013333333
111111110111111010111111011111111
100040000100000010000001000040001
101111110101111111111101011111101
100000004000000000000000400000001
101111110111111010111111011111101
1000400000p00000100000000000400g1
111111111111111111111111111111111
0 ball
1 1all
2 gate          (only one)
p pa4man        (only one)
g ghost         (only four)
3 blank
4 po1er ball
x pa4manT1o
