111111111111111111111111111111111
100040000000000010000000000040001
101111110111111010111111011111101
100000004000000000000000400000001
101111110101111111111101011111101
100040000100000010000001000040001
111111110111111010111111011111111
3333333101004000g0004001013333333
333333310101112222211101013333333
333333310001000g00000100013333333
333333310101000gg0000101013333333
333333310001000000000100013333333
333333310101111111111101013333333
333333310100400000004001013333333
111111110111111010111111011111111
1000400001P0000010000001000040001
101111110101111111111101011111101
100000004000000000000000400000001
101111110111111010111111011111101
1000400000p0000010000000000040001
111111111111111111111111111111111
0 ball
1 1all
2 gate          (only one)
p pa4man        (only one)
g ghost         (only four)
3 blank
4 po1er ball
x pa4manT1o
